42
18
1,1,1,1,1,2,2,2,17,2,2,2,17,2,2,17,1,1,3,3,1,1,2,2,2,2,2,17,1,1,1,1,3,3,3,3,1,1,1,2,2,17,
0,0,0,1,1,1,1,1,1,2,17,2,2,2,17,2,17,1,1,3,3,1,1,2,2,2,17,1,1,1,3,3,3,1,1,1,1,2,2,2,2,17,
0,0,0,0,0,0,0,1,1,1,1,1,2,17,2,2,2,17,1,1,3,1,1,1,1,1,1,1,3,3,3,1,1,1,2,2,2,2,2,2,2,17,
0,0,7,0,7,0,0,3,3,3,1,1,1,17,2,2,2,2,17,1,3,3,1,1,1,1,3,3,3,1,1,1,2,2,17,1,1,5,5,0,2,17,
0,0,0,0,0,0,0,7,0,3,3,1,1,1,2,2,2,2,17,1,1,3,1,1,1,3,3,1,1,1,2,2,17,1,1,1,9,19,1,2,2,17,
0,7,0,0,7,0,0,0,0,0,3,3,3,1,1,2,2,2,2,17,1,3,1,1,1,3,0,1,1,2,17,1,1,1,1,9,19,1,1,2,2,17,
0,0,0,0,0,0,0,0,0,7,0,0,3,3,1,1,2,2,2,17,1,3,1,6,3,3,0,0,1,1,1,1,1,9,9,19,0,1,2,2,2,17,
0,7,0,0,7,0,0,9,9,9,9,9,19,8,8,9,9,9,19,1,1,3,3,8,3,0,0,0,9,9,9,9,9,19,0,0,2,2,2,2,2,17,
0,0,6,9,9,9,9,19,0,0,0,0,0,0,3,3,2,17,9,9,9,19,8,9,9,9,9,9,19,0,1,1,1,1,2,2,2,2,2,2,2,17,
7,0,0,7,0,0,0,0,7,0,0,0,0,0,0,3,1,2,2,2,17,1,3,0,0,0,0,0,0,0,0,0,0,1,2,2,2,2,2,2,2,17,
0,0,0,0,0,7,0,0,0,0,0,7,0,0,0,3,3,1,2,17,1,1,3,0,0,0,0,0,0,7,0,0,0,1,1,1,2,2,2,2,2,17,
0,0,7,0,0,0,0,7,0,0,0,0,0,0,0,0,3,3,1,1,1,3,3,0,7,0,0,0,0,0,0,0,7,0,0,1,1,1,2,2,2,17,
0,0,0,0,0,0,0,0,0,0,7,0,0,0,0,0,0,3,1,1,1,3,0,0,0,0,0,0,0,0,7,0,0,0,0,0,0,1,1,1,2,17,
0,0,0,0,0,7,0,0,0,0,0,0,0,7,0,0,0,3,1,1,1,3,0,7,0,0,7,0,0,0,0,0,0,7,0,0,7,0,0,1,1,1,
0,7,0,0,0,0,0,0,7,0,0,0,0,0,0,0,0,3,1,1,3,3,0,0,0,0,0,0,0,0,7,0,0,0,0,0,0,0,0,0,7,0,
0,0,0,0,7,0,0,0,0,0,7,0,0,0,0,0,0,3,3,1,3,0,0,0,7,0,0,7,0,0,0,0,0,7,0,0,0,0,7,0,0,0,
0,0,0,5,5,5,17,0,0,0,0,0,0,7,0,0,0,0,3,3,3,0,0,0,0,0,0,0,0,0,7,0,0,0,0,7,0,0,0,0,7,0,
0,7,0,0,0,0,0,7,0,0,0,0,0,0,0,7,0,0,3,3,0,0,7,0,0,7,0,0,0,0,0,0,0,7,0,0,0,0,7,0,0,0,
